180#320
2#0#0#0#0#0#0#0#0#0#0#0#0#0#0#0#0#0#0#0#0#0#0#0#0#0
2#2#0#0#0#0#0#0#0#0#0#0#0#0#0#0#0#0#0#0#0#0#0#0#0#0
2#1#2#0#0#0#0#0#0#0#0#0#0#0#0#0#0#0#0#0#0#0#0#0#0#0
2#1#1#2#0#0#0#0#0#0#0#0#0#0#0#0#0#0#0#0#0#0#0#0#0#0
2#1#1#1#2#0#0#0#0#0#0#0#0#0#0#0#0#0#0#0#0#0#0#0#0#0
2#1#1#1#1#2#0#0#0#0#0#0#0#0#0#0#0#0#0#0#0#0#0#0#0#0
2#1#1#1#1#1#2#0#0#0#0#0#0#0#0#0#0#0#0#0#0#0#0#0#0#0
2#1#1#1#1#1#1#2#0#0#0#0#0#0#0#0#0#0#0#0#0#0#0#0#0#0
2#1#1#1#1#1#1#1#2#0#0#0#0#0#0#0#0#0#0#0#0#0#0#0#0#0
2#1#1#1#1#1#1#1#1#2#0#0#0#0#0#0#0#0#0#0#0#0#0#0#0#0
2#1#1#1#1#1#1#1#1#1#2#0#0#0#0#0#0#0#0#0#0#0#0#0#0#0
2#1#1#1#1#1#1#1#1#1#1#2#0#0#0#0#0#0#0#0#0#0#0#0#0#0
2#1#1#1#1#1#1#1#1#1#1#1#2#0#0#0#0#0#0#0#0#0#0#0#0#0
2#1#1#1#1#1#1#1#1#1#1#1#1#2#0#0#0#0#0#0#0#0#0#0#0#0
2#1#1#1#1#1#1#1#1#1#1#1#1#1#2#0#0#0#0#0#0#0#0#0#0#0
2#1#1#1#1#1#1#1#1#1#1#1#1#1#1#2#0#0#0#0#0#0#0#0#0#0
2#1#1#1#1#1#1#1#1#1#1#1#1#1#1#1#2#0#0#0#0#0#0#0#0#0
2#1#1#1#1#1#1#1#1#1#1#1#1#1#1#1#1#2#0#0#0#0#0#0#0#0
2#1#1#1#1#1#1#1#1#1#1#1#1#1#1#1#1#1#2#0#0#0#0#0#0#0
2#1#1#1#1#1#1#1#1#1#1#1#1#1#1#1#1#1#1#2#0#0#0#0#0#0
2#1#1#1#1#1#1#1#1#1#1#1#1#1#1#1#1#1#1#1#2#0#0#0#0#0
2#1#1#1#1#1#1#1#1#1#1#1#1#1#1#1#1#1#1#1#1#2#0#0#0#0
2#1#1#1#1#1#1#1#1#1#1#1#1#1#1#1#1#1#1#1#1#1#2#0#0#0
2#1#1#1#1#1#1#1#1#1#1#1#1#1#1#1#1#1#1#1#1#1#1#2#0#0
2#1#1#1#1#1#1#1#1#1#1#1#1#1#1#1#1#1#1#1#1#1#1#1#2#0
2#1#1#1#1#1#1#1#1#1#1#1#1#1#1#1#1#1#1#1#1#1#1#1#1#2
2#1#1#1#1#1#1#1#1#1#1#1#1#1#1#1#1#1#1#1#1#1#1#1#1#2
2#1#1#1#1#1#1#1#1#1#1#1#1#1#1#1#1#1#1#1#1#1#1#1#1#2
2#1#1#1#1#1#1#1#1#1#1#1#1#1#1#1#1#1#1#1#1#1#1#1#1#2
2#1#1#1#1#1#1#1#1#1#1#1#1#1#1#1#1#1#1#1#1#1#1#1#1#2
2#1#1#1#1#1#1#1#1#1#1#1#1#1#1#1#1#1#1#1#1#1#1#1#1#2
2#3#1#1#1#1#1#1#1#1#1#1#1#1#1#1#1#1#1#1#1#1#1#1#1#2
0#2#8#1#1#1#1#1#1#1#1#1#1#1#1#1#1#1#1#1#1#1#1#1#1#2
0#0#2#1#1#1#1#1#1#1#1#1#1#1#1#1#1#1#1#1#1#1#1#1#1#2
0#0#0#2#1#1#1#1#1#1#1#1#1#1#1#1#1#1#1#1#1#1#1#1#1#2
0#0#0#0#2#1#1#1#1#1#1#1#1#1#1#1#1#1#1#1#1#1#1#1#1#2
0#0#0#0#0#2#1#1#1#1#1#1#1#1#1#1#1#1#1#1#1#1#1#1#1#2
0#0#0#0#0#0#2#1#1#1#1#1#1#1#1#1#1#1#1#1#1#1#1#1#1#2
0#0#0#0#0#0#0#2#1#1#1#1#1#1#1#1#1#1#1#1#1#1#1#1#1#2
0#0#0#0#0#0#0#0#2#1#1#1#1#1#1#1#1#1#1#1#1#1#1#1#1#2
0#0#0#0#0#0#0#0#0#2#1#1#1#1#1#1#1#1#1#1#1#1#1#1#1#2
0#0#0#0#0#0#0#0#0#0#2#1#1#1#1#1#1#1#1#1#1#1#1#1#1#2
0#0#0#0#0#0#0#0#0#0#0#2#1#1#1#1#1#1#1#1#1#1#1#1#1#2
0#0#0#0#0#0#0#0#0#0#0#0#2#1#1#1#1#1#1#1#1#1#1#1#1#2
0#0#0#0#0#0#0#0#0#0#0#0#0#2#1#1#1#1#1#1#1#1#1#1#1#2
0#0#0#0#0#0#0#0#0#0#0#0#0#0#2#1#1#1#1#1#1#1#1#1#1#2
0#0#0#0#0#0#0#0#0#0#0#0#0#0#0#2#1#1#1#1#1#1#1#1#1#2
0#0#0#0#0#0#0#0#0#0#0#0#0#0#0#0#2#1#1#1#1#1#1#1#1#2
0#0#0#0#0#0#0#0#0#0#0#0#0#0#0#0#0#2#1#1#1#1#1#1#1#2
0#0#0#0#0#0#0#0#0#0#0#0#0#0#0#0#0#0#2#1#1#1#1#1#1#2
0#0#0#0#0#0#0#0#0#0#0#0#0#0#0#0#0#0#0#2#1#1#1#1#1#2
0#0#0#0#0#0#0#0#0#0#0#0#0#0#0#0#0#0#0#0#2#1#1#1#1#2
0#0#0#0#0#0#0#0#0#0#0#0#0#0#0#0#0#0#0#0#0#2#1#1#1#2
0#0#0#0#0#0#0#0#0#0#0#0#0#0#0#0#0#0#0#0#0#0#2#1#1#2
0#0#0#0#0#0#0#0#0#0#0#0#0#0#0#0#0#0#0#0#0#0#0#2#1#2
0#0#0#0#0#0#0#0#0#0#0#0#0#0#0#0#0#0#0#0#0#0#0#0#2#2
0#0#0#0#0#0#0#0#0#0#0#0#0#0#0#0#0#0#0#0#0#0#0#0#0#2#2